11111111
10001001
10001001
10000001
10100P01
10100001
11111111