111111111111111111111111111
100000000100000000000001001
100000000100000000000001001
100000000111110000000000001
100000000111110000000000001
100000000111110000000000001
100000000111110000000000001
100000000111110000000000001
100000000000000000000000001
100000000000000000000000001
100000000000000000000000001
100000000000000000000000001
100000000000000000000000001
101000000000000000000000P01
101000000000000000000000001
111111111111111111111111111