NO _textures/wall.xpm42
SO _textures/wall.xpm42
WE _textures/floor.xpm42
EA _textures/floor.xpm42

F 220,100,0
C 225,30,0

1111111111111111
1000101D10000001
1000100100000001
100S000D10000001
1010000100000001
10100001001D1001
1111111111111111
