NO _textures/char11.xpm42
SO _textures/char21.xpm42
WE _textures/char31.xpm42
EA _textures/char41.xpm42


F 255,0,0
C 0,0,255

111111111111111111111111111
100000000100000000000001001
10N000000100000000000001001
100000000111110000000000001
100000000111110000000000001
100000000111110000000000001
100000000111110000000000001
100000000111110000000000001
100000000000000000000000001
100000000000000000000000001
100000000000000000000000001
100000000000000000000000001
100000000000000000000000001
101000000000000000000000001
101000000000000000000000001
111111111111111111111111111