NO _textures/test.xpm42
SO _textures/test.xpm42
WE _textures/test.xpm42
EA _textures/test.xpm42


F 129,158,150
C 225,30,0


111111111111111111111111111
100000000000000000000001001
10N000000000000000000001001
100000001111110000000000001
100000001111110000000000001
100000001111110000000000001
100000001111110000000000001
100000001111110000000000001
100000001000000000000000001
100000001000000000000000001
101111111111111100000000001
100000001000000000000000001
100000001000000000000000001
101000001000000000000000001
101000001000000000000000001
111111111111111111111111111