NO ./path_to_the_north_texture
SO ./path_to_the_south_texture
WE ./path_to_the_west_texture
EA ./path_to_the_east_texture


F 129,158,150
C 225,30,0


111111111111111111111111111
100000000100000000000001001
100000000100000000000001001
100000000111110000000000001
100000000111110000000000001
100000000111110000000000001
100000000111110000000000001
100000000111110000000000001
100000000000000000000000001
100000000000000000000000001
100000000000000000000000001
100000000000000000000000001
100000000000000000000000001
101000000000000000000000N01
101000000000000000000000001
111111111111111111111111111