NO _textures/mob1.xpm42
SO _textures/mob2.xpm42
WE _textures/mob3.xpm42
EA _textures/mob4.xpm42


F 129,158,150
C 225,30,0


             111111111111111111111111111
             100000000000000000000001001
             10N000000000000000000001001
             100000011111110000000000001
             100000011011110000000000001
             100000011011110000000000001
             100000011011110000000000001
             100000011011110000000000001
             100000011000000000000000001
             101111111111111100000000001
             101111111111111100000000001
             100000011000000000000000001
             100000011000000000000000001
             101000011000000000000000001
             101000011000000000000000001
             111111111111111111111111111