NO _textures/test.xpm42
SO _textures/test.xpm42
WE _textures/test.xpm42
EA _textures/test.xpm42

F 220,100,0
C 225,30,0

11111
10001
11N01
10001
11111